00000000000000000000000000000000000000000000000000
00000000000000000000000000000000000000000000000000
00000000000000000001111111111111111111111111111110
00000000000000000111111111111111111111111111111110
00000000000010001111111111111111111111111111111110
00000000000010011111000011000000001111111111111110
00000000000111011111000111000000001111111111111110
00000000000101011000000001100000000000001111111110
00000000000000000000000011000000000000000100011110
00000000000000011111110000000000000001111111111110
00000000001111111111111111111111111111111111111110
00000000111111111111111111111111111111111111111110
00001111111111111111111111111111111111110000000000
00001111111000000000111111111101110000000000000000
00000111111000000000011111100000000000000000000000
00001111111000000000011110000000000000000000000000
00000001000000000000000000000000000000000000000000
00000111110000000000000000000000000000000000000000
00000111110000000000000000000000000000000000000000
00000000000000000000000000000000000000000000000000
00000000000000000000000000000000000000000000000000
00000000000000000000000000000000000000000000000000